12
20
22222222222222222222
2S202200200200220022
20002002020002022002
20022000202200200202
22002002020000000022
22022020000220022002
20002000020020022202
20000002000220000022
22200200202200002002
22222200220202020T02
20020220002000220002
22222222222222222222